 ++*%*==: :==========     
+-::==.           :+*=    
 :::==.            -+=    
*-::==.  :#######  :#:    
    .-. -====::===:.-=    
     +- *#*-##+=##+.-=    
     =: +**=:+****=.-=    
     -. :-.---..--:.-=    
     -. ::: .:::::..-=    
     -.            .-=    
     *%-           .==    
     -:   #+===========+**
     -:   #:::::::::::::=*
     .=--#*============++ 